package_name,actual_price,trip_price,visiting_places,hotel_ratings,city_name,discount,days,no.of_visiting_cities
Bestselling Rishikesh Mussoorie Tour Package From Delhi,12545,11549,"Rishikesh (1D),Mussoorie (2D),","3 Star,",Rishikesh ,996,3,2
Best Hong Kong Macau Tour Packages For An Impeccable Vacation,43157,39999,"Hong Kong (4D),Macau (3D),","3 Star,",Hong Kong ,3158,7,2
Coorg Package For 2 Nights And 3 Days,17802,16200,"Coorg (3D),","3 Star,2 Star,4 Star,",Coorg ,1602,3,1
Refreshing Maldives Family Tour Packages From India,80000,35000,"Maldives (5D),","3 Star,4 Star,5 Star,",Maldives ,45000,5,1
Best 4N 5D Andaman Sightseeing Tour Package For A Refreshing Getaway,36484,33200,"Port Blair (4D),Havelock (1D),","3 Star,",Port Blair ,3284,5,2
Mesmerising Manali Trip Package From Chandigarh,10440,9500,"Manali (3D),","3 Star,4 Star,",Manali ,940,3,1
Most Affordable 1 Night 2 Days Uttarakhand Tour Packages From Delhi,3360,2800,"Rishikesh (2D),","3 Star,4 Star,5 Star,",Rishikesh ,560,2,1
Splendid Dubai Abu Dhabi Tour Packages For An Amazing Holiday,26595,24999,"Dubai (7D),","3 Star,4 Star,",Dubai ,1596,7,1
Top Family Holiday Packages in Goa for an Ideal Family Vacation,15217,14000,"Calangute (5D),","2 Star,3 Star,4 Star,",Calangute ,1217,5,1
Top 4 Nights 5 Days Best-Selling Sikkim Gangtok Darjeeling Tour Package,22956,19233,"Gangtok (2D),Darjeeling (3D),","3 Star,4 Star,5 Star,",Gangtok ,3723,5,2
Best Selling Kerala Houseboat & Jungle Safari Tour Package,21993,17920,"Munnar (2D),Thekkady (1D),Alleppey (2D),","3 Star,4 Star,5 Star,",Munnar ,4073,5,3
Top Greece Tour Packages For An Enthralling Experience In Europe,74974,68726,"Athens (3D),Santorini (2D),Mykonos (2D),","2 Star,3 Star,4 Star,5 Star,",Athens ,6248,7,3
Go on an excursion to Shillong to witness the best of natural attraction,23563,20500,"Kaziranga (2D),Shillong (2D),Guwahati (2D),","3 Star,",Kaziranga ,3063,6,3
4 Nights 5 Days Mauritius Family Tour Packages for a Refreshing Getaway,42840,37699,"Mauritius (5D),","3 Star,4 Star,5 Star,",Mauritius ,5141,5,1
Top 5 Nights 6 Days Kerala Family Tour Packages For A Refreshing Getaway,24008,19643,"Munnar (2D),Thekkady (1D),Alleppey (1D),Kochi (2D),","3 Star,2 Star,4 Star,",Munnar ,4365,6,4
Wonderful Bhutan Family Package,20716,18644,"Thimphu (2D),Paro (3D),","3 Star,",Thimphu ,2072,5,2
Best Selling 4 Nights and 5 Days Hong Kong Family Tour Packages,33000,30000,"Hong Kong (5D),","4 Star,",Hong Kong ,3000,5,1
Exciting Goa Tour Packages For A Perfect Getaway,16692,15500,"Goa (3D),","2 Star,4 Star,",Goa ,1192,3,1
Discover Our Beautiful 4 Nights 5 Days Andaman Family Tour Packages,23574,18990,"Port Blair (4D),Havelock (1D),","4 Star,",Port Blair ,4584,5,2
Marvelous Singapore Family Package,30656,28999,"Singapore (5D),","3 Star,4 Star,",Singapore ,1657,5,1
Best Selling Paris Tour Packages For An Exquisite European Vacation,93333,84000,"Paris (4D),","2 Star,3 Star,",Paris ,9333,4,1
4 Nights 5 Days Sikkim Family Tour Package,51262,42718,"Gangtok (4D),Lachung (1D),","2 Star,3 Star,5 Star,",Gangtok ,8544,5,2
Explore The Lion City With Best Singapore Sightseeing Tour Package,53846,49000,"Singapore (5D),","3 Star,",Singapore ,4846,5,1
Best Selling Vietnam and Cambodia Tour Packages for a Memorable Trip,32401,29049,"Ho Chi Minh City (3D),Siem Reap (2D),Phnom Penh (3D),","3 Star,4 Star,5 Star,",Ho Chi Minh City ,3352,8,3
Jammu Kashmir Family Package,23630,21952,"Katra (1D),Pahalgam (1D),Srinagar (4D),Gulmarg (1D),","3 Star,",Katra ,1678,7,4
Udaipur: More Than The Just âThe City Of Lakesâ,7539,6499,"Udaipur (3D),","2 Star,3 Star,4 Star,",Udaipur ,1040,3,1
Classic Holiday Package To Australia,91455,84999,"Sydney (3D),Melbourne (3D),Gold Coast (4D),","3 Star,",Sydney ,6456,10,3
Idyllic Kerala Houseboat & Hills Family Package ,37825,31837,"Munnar (2D),Thekkady (1D),Alleppey (1D),Kovalam (3D),","3 Star,4 Star,5 Star,",Munnar ,5988,7,4
Adventurous Family Holiday In Coorg,15417,14029,"Coorg (2D),Mysore (2D),","3 Star,4 Star,",Coorg ,1388,4,2
Lovely Ladakh Family Package,21504,19999,"Leh (3D),Nubra Valley (1D),Pangong (1D),","3 Star,4 Star,5 Star,",Leh ,1505,5,3
Colorful Rajasthan Family Package,76404,68000,"Jaipur (2D),Bikaner (1D),Jaisalmer (2D),Jodhpur (1D),Udaipur (3D),","3 Star,4 Star,5 Star,",Jaipur ,8404,9,5
Best Selling Bali Family Package,42483,37600,"Kuta (4D),Seminyak (4D),","3 Star,4 Star,5 Star,",Kuta ,4883,8,2
Amazing Europe Family Package,155769,141750,"Rome (2D),Venice (2D),INTERLAKEN (2D),Lucerne, Switzerland (3D),","2 Star,3 Star,4 Star,",Rome ,14019,9,5
Best Of Seychelles Family Package ,71477,65804,"Praslin (2D),La digue  (2D),Mahe (3D),","2 Star,3 Star,4 Star,",Praslin ,5673,7,3
Sri Lanka Family Vacation: Wildlife & Beaches,31337,27500,"Kandy (1D),Nuwara Eliya (1D),Yala National Park (1D),Bentota (2D),Colombo (1D),","3 Star,4 Star,5 Star,",Kandy ,3837,6,5
Vivid Vietnam and Cambodia Family Package,34444,31000,"Ho Chi Minh City (3D),Siem Reap (3D),","4 Star,5 Star,",Ho Chi Minh City ,3444,6,2
Best 8 Nights 9 Days Himachal Family Tour Package for a Soothing Getaway,32143,30000,"Shimla (2D),Manali (3D),Dharamshala (1D),Dalhousie (3D),","3 Star,4 Star,5 Star,",Shimla ,2143,9,4
"Explore Darjeeling And Gangtok, The Gem Of Northeast",80136,72122,"Gangtok (3D),Kalimpong (1D),Darjeeling (3D),","3 Star,",Gangtok ,8014,7,3
Exciting Dubai Tour With Ferrari World (Kidâs Special),37636,34500,"Dubai (5D),","3 Star,",Dubai ,3136,5,1
Memorable Family Vacation,27802,25300,"Kuta (2D),Seminyak (3D),","4 Star,",Kuta ,2502,5,2
Super Saver Dubai Vacation: Desert Safari & Burj Khalifa,30176,28500,"Dubai (5D),","5 Star, Hotels Included",Dubai ,1676,5,1
Breathtaking Bangkok Tour Package,25275,23000,"Krabi (2D),Bangkok (3D),","â¹ 62,000/-",Krabi ,2275,5,2
Charismatic Kochi Tour Package,16011,14570,"Dubai (5D),","3 Star,",Dubai ,1441,5,1
Dubai : An Extravagant Odyssey ,67542,54999,"Bali (5D),","3 Star,4 Star,5 Star,",Bali ,12543,5,1
Best Selling Weeklong Goa Tour Packages For A Fun-Filled Vacay,17608,16199,"Goa (6D),","3 Star,",Goa ,1409,6,1
Mauritius Family Vacation: Wildlife & Beaches,42840,37699,"Mauritius (5D),","4 Star,5 Star,",Mauritius ,5141,5,1
Mystical Bhutan Tour Package,28560,25990,"Phuntsholing (3D),Thimphu (1D),Punakha (1D),Paro (2D),","3 Star,",Phuntsholing ,2570,7,4
Splendid Singapore And Bali Family Package ,66667,60000,"Singapore (2D),Kuta (5D),","4 Star,",Singapore ,6667,7,2
Spectacular Paro Tour Package,13659,12430,"Paro (3D),","3 Star,",Paro ,1229,3,1
Mauritius And Dubai Family Tour Package,60924,56273,"Mauritius (5D),Dubai (5D),","2 Star,3 Star,5 Star,",Mauritius ,4651,10,2
Extravagant Port Blair Sightseeing Tour Packages,13846,12600,"Port Blair (4D),","3 Star,",Port Blair ,1246,4,1
Mesmerizing Leh Ladakh Family Tour Package,19779,17999,"Leh (5D),","3 Star,",Leh ,1780,5,1
Amazing Sydney Sightseeing Tour Package,58791,53500,"Sydney (3D),Gold Coast (4D),","4 Star,",Sydney ,5291,7,2
Fun-filled Family Mauritius Holiday Package,31572,26824,"Mauritius (6D),","5 Star,",Mauritius ,4748,6,1
Pleasurable Pattaya Tour Package,13736,12500,"Pattaya (4D),","3 Star,",Pattaya ,1236,4,1
Swanky Vacation At Splendid Krabi,28022,25500,"Krabi (4D),","4 Star,",Krabi ,2522,4,1
Ecstatic Shimla 4 Night 5 Day Tour Package,14205,12500,"Shimla (5D),","3 Star,",Shimla ,1705,5,1
An Adventurous Family Trip To Jim Corbett National Park,7933,7219,"Jim Corbett (2D),","3 Star,",Jim Corbett ,714,2,1
Mesmerizing Getaway To Kochi,4593,4180,"Kochi (2D),","2 Star,",Kochi ,413,2,1
Mesmerising Lansdowne Tour Package,17308,15750,"Lansdowne (3D),","3 Star,4 Star,",Lansdowne ,1558,3,1
Gangtok Family Package For 3 Days,19163,18013,"Gangtok (3D),","3 Star,4 Star,5 Star,",Gangtok ,1150,3,1
Kerala Wayanad Weekend Holiday,8253,7840,"Wayanad (3D),","3 Star,",Wayanad ,413,3,1
Dazzling Dubai Family Package,27777,24999,"Dubai (5D),","2 Star,",Dubai ,2778,5,1
A Goa Tour Full of Fun n Frolic,12637,11500,"Goa (4D),","2 Star,",Goa ,1137,4,1
Unique Bhutan Sightseeing Tour Packages,16763,15254,"Phuntsholing (1D),Paro (2D),Thimphu (2D),","3 Star,2 Star,4 Star,",Phuntsholing ,1509,5,3
Charming Kashmir Sightseeing Tour Package,30769,28000,"Srinagar (4D),Pahalgam (2D),Gulmarg (2D),","3 Star,4 Star,",Srinagar ,2769,8,3
Amazing Andaman Tour Package,19216,18163,"Port Blair (4D),Havelock Island (1D),Neil Island (1D),","3 Star,",Port Blair ,1053,6,3
"Gangtok, Lachung & Darjeeling Summer Special Tour: The North Eastern Bliss ",67710,62399,"Gangtok (3D),Lachen (1D),Lachung (1D),Darjeeling (2D),","2 Star,3 Star,4 Star,",Gangtok ,5311,7,4
Best 2 Nights 3 Days Kodaikanal Tour Exclusive Package,12736,11590,"Kodaikanal (3D),","4 Star,",Kodaikanal ,1146,3,1
"Exhilarating Gangtok, Kalimpong and Darjeeling Trip in Summer",33362,29692,"Gangtok (2D),Kalimpong (1D),Darjeeling (3D),","4 Star,",Gangtok ,3670,6,3
Fascinating Istanbul Sightseeing Tour Package,52921,48158,"Istanbul (4D),","3 Star,",Istanbul ,4763,4,1
Amazing Santorini Tour Package,26538,24150,"Santorini (3D),","3 Star,",Santorini ,2388,3,1
Exciting Rajasthan Tour Package,8680,7899,"Ranthambore (2D),","3 Star,",Ranthambore ,781,2,1
Check Out Our Top-rated Andaman Itinerary For 4 Days For A Soulful Vacay,18462,16800,"Port Blair (3D),Havelock (1D),","4 Star,",Port Blair ,1662,4,2
An Tour In Glitzy Dubai,40659,37000,"Dubai (6D),","3 Star,",Dubai ,3659,6,1
Awesome Singapore and Malaysia Tour Package,39998,35998,"Singapore (3D),Kuala Lumpur (3D),","3 Star,",Singapore ,4000,6,2
Fascinating Manali Tour Package From Ahmedabad,10989,10000,"Manali (4D),","3 Star,",Manali ,989,4,1
Resounding Rajasthan Family Package,8240,7498,"Jaisalmer (3D),","3 Star,",Jaisalmer ,742,3,1
Spectacular Dubai Sightseeing Tour Packages,50549,46000,"Dubai (7D),","3 Star,",Dubai ,4549,7,1
Pleasant Bhutan Tour Package,19780,18000,"Phuntsholing (2D),Thimphu (2D),Paro (2D),","3 Star,",Phuntsholing ,1780,6,3
A Marvellous Netherlands Tour Package,20769,18900,"Amsterdam (2D),Netherlands (1D),","3 Star,",Amsterdam ,1869,3,2
Phenomenal Vietnam Tour Package,46043,41899,"Hanoi (4D),Halong Bay (1D),Sapa (3D),","5 Star,",Hanoi ,4144,8,3
Catch The Beauty Of The Setting Sun In Alleppey,4922,4479,"Alleppey (2D),","3 Star,",Alleppey ,443,2,1
Luxurious Singapore Summer Special Honeymoon Tour Package,69560,63300,"Singapore (4D),","3 Star,",Singapore ,6260,4,1
Adventure Packed Rishikesh Tour Package,4395,3999,"Rishikesh (2D),","5 Star,",Rishikesh ,396,2,1
Best Selling Ooty Mysore Tour Packages for a Relaxing Holiday,14556,12809,"Ooty (4D),","3 Star,",Ooty ,1747,4,1
Amazing Trip To Bangkok And Phuket,43846,39900,"Bangkok (2D),Phuket (3D),","4 Star,",Bangkok ,3946,5,2
Splendid Jaisalmer Tour Package,8152,7500,"Jaisalmer (3D),","3 Star,",Jaisalmer ,652,3,1
Fabulous Belgium Tour Package,23333,21000,"Brussels (3D),","3 Star,",Brussels ,2333,3,1
Splendid Kathmandu Tour Package,13260,12199,"kathmandu (4D),","3 Star,",kathmandu ,1061,4,1
A Blissful Tour In Munnar,9844,8958,"Munnar (3D),","3 Star,",Munnar ,886,3,1
"Goa Is All About Sand, Sun, And Sea",7692,7000,"Goa (3D),","3 Star,",Goa ,692,3,1
Santorini Tour: An Amazing Trip,51923,47250,"Mykonos (2D),Santorini (3D),","3 Star,",Mykonos ,4673,5,2
Fantastic Summer Special Trip To Manali,13187,12000,"Manali (4D),","5 Star,",Manali ,1187,4,1
Ecstatic Seychelles Sightseeing Tour Packages,33803,30761,"Mahe Island (5D),","4 Star,4 Star,",Mahe Island ,3042,5,1
Ecstatic Bali Vacation,43333,39000,"Nusa Dua (2D),Seminyak (3D),","3 Star,",Nusa Dua ,4333,5,2
Thailand Family Tour Package To Pattaya And Bangkok,12500,11000,"Pattaya (3D),Bangkok (2D),","3 Star,",Pattaya ,1500,5,2
Astounding Kasol Tour Packages,17778,16000,"Kasol (2D),Kheerganga (2D),","3 Star,",Kasol ,1778,4,2
Relaxing Maldives Family Package,86667,80000,"Maldives (5D),","3 Star,4 Star,",Maldives ,6667,5,1
Stunning Singapore Tour Packages For An Amusing Holiday,39473,29999,"Singapore (5D),","3 Star,",Singapore ,9474,5,1
Enjoyable Europe Family Package,163333,147000,"INTERLAKEN (2D),Lucerne, Switzerland (2D),Zurich (1D),Paris (2D),Amsterdam (3D),","3 Star,",INTERLAKEN ,16333,10,6
Magnificent Leh Sightseeing Tour Packages,26373,23999,"Leh (5D),Nubra Valley (1D),","3 Star,",Leh ,2374,6,2
Fascinating Abu Dhabi Tour Package,31868,29000,"Abu Dhabi (2D),","2 Star,",Abu Dhabi ,2868,2,1
Ecstatic Athirapally Tour Package,30904,28123,"Athirapally (2D),Munnar (2D),Alleppey (1D),Kovalam (1D),Trivandrum (2D),","3 Star,",Athirapally ,2781,8,5
Best-Selling Sightseeing Vacation To Gangtok,14531,13223,"Gangtok (4D),","3 Star,",Gangtok ,1308,4,1
Best Selling Lansdowne Tour For A Refreshing Getaway In 2021,6416,5774,"Lansdowne (2D),","3 Star,",Lansdowne ,642,2,1
Wonderful And Memorable Turkey Trip,87384,79519,"Istanbul (2D),Kusadasi (2D),Pamukkale (1D),Antalya (2D),Cappadocia (3D),","3 Star,",Istanbul ,7865,10,5
Tranquil Bhutan Tour Package,26076,23729,"Thimphu (2D),Punakha (1D),Paro (3D),","3 Star,4 Star,5 Star,",Thimphu ,2347,6,3
Gorgeous Goa Tour Packages From Kerala,10989,10000,"Goa (4D),","4 Star,",Goa ,989,4,1
Mesmerizing Kerala Holiday: Weekend in Munnar & Thekkady,18434,13167,"Munnar (2D),Thekkady (2D),","4 Star,",Munnar ,5267,4,2
 Idyllic Seychelles Tour Packages,75857,69030,"Praslin (2D),Mahe Island (2D),Seychelles (1D),","4 Star,",Praslin ,6827,5,3
Exhilarating Bali Tour,30659,27900,"Kuta (3D),Seminyak (3D),","4 Star,",Kuta ,2759,6,2
Top Selling 3 Nights And 4 Days Pattaya Tour Packages,15556,14000,"Pattaya (4D),","4 Star,4 Star,5 Star,",Pattaya ,1556,4,1
Uber Romantic Greece Honeymoon Package,98076,89249,"Athens (4D),Mykonos (2D),Santorini (4D),","3 Star,",Athens ,8827,10,3
Best Selling Adventurous Sri Lanka Tour Package,31988,28789,"Sigiriya  (2D),Kandy (1D),NuwaraEliya (1D),Bentota (1D),Colombo (2D),","2 Star,3 Star,4 Star,",Sigiriya  ,3199,7,5
Darjeeling Family Package for 3 Days,10229,9513,"Darjeeling (3D),","3 Star,",Darjeeling ,716,3,1
3 Nights 4 Days Paradisiacal Himachal Family Package For A Peaceful Trip,9091,8000,"Manali (4D),","3 Star,",Manali ,1091,4,1
Gorgeous Greece Sightseeing Tour Package,74997,68247,"Athens (3D),Santorini (2D),Mykonos (2D),","4 Star,",Athens ,6750,7,3
Splendid Switzerland & France Tour Package,86538,78750,"Paris (3D),Zurich (4D),","5 Star,",Paris ,7788,7,2
Fabulous Pokhara Tour Package,22197,20199,"POKHARA (2D),kathmandu (2D),","3 Star,",POKHARA ,1998,4,2
A Perfect Mauritius Honeymoon Package,123846,112700,"Mahe Island (3D),Mauritius (6D),","3 Star,4 Star,5 Star,",Mahe Island ,11146,9,2
Amazing Netherland Tour Package,60000,54600,"Paris (2D),Amsterdam (4D),","3 Star,",Paris ,5400,6,2
Visit Kerala And See Astounding Places,13213,11760,"Munnar (1D),Thekkady (1D),Kochi (2D),","4 Star,",Munnar ,1453,4,3
Goa Package For 2 Nights 3 Days,7692,7000,"Macau (2D),Hong Kong (3D),","4 Star,",Macau ,692,5,2
Exhilarating Hong Kong Tour Package,38461,35000,"Macau (2D),Hong Kong (4D),","4 Star,",Macau ,3461,6,2
Fabulous Hong Kong & Macau Tour Packages,43428,39999,"Amman (1D),Tiberias (1D),Bethlehem (3D),Taba (2D),Cairo (2D),","3 Star,",Amman ,3429,9,5
Holyland Israel Tour Package: Egypt & Jordan,131797,117299,"Jaipur (2D),Bikaner (1D),Jaisalmer (2D),Jodhpur (2D),","3 Star,",Jaipur ,14498,7,4
Best-Selling 7 Days Rajasthan Tour Packages For Memorable Vacay,57142,51999,"Rishikesh (2D),","3 Star,",Rishikesh ,5143,2,1
Adventure-Loaded Rishikesh Tour Package,11667,10500,"Maafushi (4D),","2 Star,3 Star,4 Star,",Maafushi ,1167,4,1
Ecstatic Maldives Family Package,49000,33000,"Srinagar (4D),Gulmarg (1D),","2 Star,",Srinagar ,16000,5,2
Best Selling Kashmir Family Package,16485,15000,"Coorg (3D),","4 Star,",Coorg ,1485,3,1
Trip To Captivating Coorg,11395,10369,"Port Blair (4D),Havelock (1D),","2 Star,",Port Blair ,1026,5,2
Exhilarating Andaman Tour Package,37041,33707,"Coorg (2D),","3 Star,",Coorg ,3334,2,1
Best Selling Holiday Tour Packages Of 1 Night 2 Days In Coorg,8714,7930,"kathmandu (2D),Changunarayan (1D),NAGARKOT (1D),","3 Star,4 Star,",kathmandu ,784,4,3
Historic Nepal Tour Package,19111,17200,"Phuket (2D),Krabi (3D),","3 Star,4 Star,5 Star,",Phuket ,1911,5,2
Explore Our Best-Selling 4 Nights 5 Days Thailand Tour Packages,25000,23000,"Dubai (5D),","3 Star,4 Star,5 Star,",Dubai ,2000,5,1
Luxe Palm Atlantis Dubai Honeymoon Package,47568,44499,"Dubai (7D),","3 Star,",Dubai ,3069,7,1
Sparkling Dubai: Desert Safari & Burj Khalifa Tour Package ,42078,38999,"New Delhi (3D),","2 Star,3 Star,4 Star,5 Star,",New Delhi ,3079,3,1
A Delightful Trip To Delhi,7142,6499,"Srinagar (4D),","3 Star,",Srinagar ,643,4,1
Charismatic 3 Nights 4 Days Kashmir Tour Packages,11950,10527,"Ranthambore (3D),","3 Star,",Ranthambore ,1423,3,1
An Utterly Ravishing Rajasthan Tour Package,11757,10699,"Shillong (2D),Cherrapunjee (1D),Guwahati (2D),","3 Star,",Shillong ,1058,5,3
Best Selling Meghalaya Tour Packages For A Rejuvenating Experience,26923,24500,"Mussoorie (2D),Dhanaulti (2D),","3 Star,",Mussoorie ,2423,4,2
Mesmerizing Uttarakhand Summer Special Family Package,39663,36093,"Cochin (1D),Munnar (2D),Thekkady (1D),Alleppey (3D),","3 Star,",Cochin ,3570,7,4
Exciting Athirapally Tour Package,27560,25080,"Bangkok (4D),","3 Star,",Bangkok ,2480,4,1
Beguiling Bangkok Tour Package,19121,17400,"Thimphu (2D),Paro (2D),","3 Star,4 Star,5 Star,",Thimphu ,1721,4,2
Soothing Bhutan Tour Package,16142,14689,"Cochin (2D),","4 Star,",Cochin ,1453,2,1
Spellbinding Cochin Family Tour Package,5091,4480,"Cappadocia (2D),Istanbul (4D),","3 Star,",Cappadocia ,611,6,2
Unforgettable Turkey Honeymoon Package ,53846,49000,"Coorg (2D),Mysore (2D),","3 Star,",Coorg ,4846,4,2
Discover Our Coorg Tour Package For 3 Nights 4 Days For A Memorable Trip,14233,12810,"Singapore (5D),","2 Star,",Singapore ,1423,5,1
Singapore Kids Friendly Tour Package,42553,40000,"Tirupati (2D),","3 Star,4 Star,",Tirupati ,2553,2,1
Tirupati Temple: A Sacred Pilgrimage,8847,8051,"Vienna (3D),Innsbruck (2D),Salzburg (2D),Budapest (2D),Prague (2D),","3 Star,",Vienna ,796,11,5
Amazing Eastern Europe Tour Package,111138,105289,"Srinagar (3D),","3 Star,",Srinagar ,5849,3,1
Charismatic Kashmir Tour Package,15000,13500,"Mauritius (7D),","2 Star,",Mauritius ,1500,7,1
Refreshing Mauritius Trip,30274,27549,"Gangtok (2D),Darjeeling (3D),","3 Star,4 Star,5 Star,",Gangtok ,2725,5,2
Exciting Sikkim Sightseeing Tour Package,36116,32866,"Praslin (2D),La digue  (2D),Mahe (4D),","3 Star,",Praslin ,3250,8,3
Amazing Seychelles Tour Package,100721,89210,"Christchurch (2D),Franz Josef (2D),Queenstown (3D),","3 Star,",Christchurch ,11511,7,3
Picturesque New Zealand Honeymoon Package,79120,71999," Ootacamund (2D),Coorg (2D),Mysore (2D),","3 Star,4 Star,", Ootacamund ,7121,6,3
Explore The Beautiful Karnataka,23044,20740,"Rome (2D),Florence (2D),Venice (3D),","3 Star,4 Star,5 Star,",Rome ,2304,7,3
Europe Italy Tour Package,69877,63525,"Dubai (4D),","3 Star,",Dubai ,6352,4,1
Choose From Our Amazing Dubai Family Tour Packages For A Memorable Trip,19713,17999,"Haridwar (1D),Mussoorie (2D),Ranikhet (1D),Kausani (1D),Nainital (3D),","4 Star,",Haridwar ,1714,8,5
Refreshing Uttarakhand Family Package,30244,27824,"Kuta (3D),Seminyak (4D),","4 Star,",Kuta ,2420,7,2
Supreme Bali Tour Package,40659,37000,"Hong Kong (6D),","3 Star,4 Star,",Hong Kong ,3659,6,1
Hong Kong Family Tour Package with Disneyland Stay,49537,45999,"Dubai (7D),","5 Star,",Dubai ,3538,7,1
Thrilling Dubai Tour: Dolphinarium & Burj Khalifa ,48467,45500,"Hong Kong (3D),Macau (3D),","3 Star,",Hong Kong ,2967,6,2
Luxurious Hong Kong & Macau Package With Venetian Stay,48139,44999,"Mussoorie (2D),Rishikesh (1D),Haridwar (2D),","3 Star,4 Star,",Mussoorie ,3140,5,3
Action-Packed Mussoorie Family Package,23077,21000,"Darjeeling (2D),Gangtok (3D),Lachung (1D),","3 Star,4 Star,5 Star,",Darjeeling ,2077,6,3
"Idyllic Sikkim, Gangtok & Darjeeling Family Package ",60211,54477,"Auckland (1D),Paihia (1D),Rotorua (2D),Queenstown (3D),Franz Josef (2D),Christchurch (2D),","3 Star,",Auckland ,5734,11,6
Best of New Zealand: Holiday In Heaven ,118109,112000,"Goa (3D),","4 Star,5 Star,",Goa ,6109,3,1
A Family Vacation In Beautiful Goa,9340,8499,"Kuta (3D),Gili Island (1D),Ubud (2D),Seminyak (3D),","3 Star,4 Star,5 Star,",Kuta ,841,9,4
Charming Bali Family Package,48862,42999,"Dubai (6D),","4 Star,",Dubai ,5863,6,1
Best Selling Dubai Holiday Package,41600,37050,"Cappadocia (2D),Kusadasi (1D),Istanbul (2D),","3 Star,4 Star,5 Star,",Cappadocia ,4550,5,3
Tempting Turkey Sightseeing Tour Package,49230,44799,"Sydney (2D),Melbourne (3D),Gold Coast (4D),","5 Star,",Sydney ,4431,9,3
Captivating Australia Family Holiday Package,90000,85000,"Colombo (2D),Maldives (4D),","3 Star,",Colombo ,5000,6,2
Maldives And Sri Lanka Family Holiday Package,139535,125000,"POKHARA (3D),","3 Star,",POKHARA ,14535,3,1
Exciting Pokhara Sightseeing Tour Packages,11208,10199,"Athirapally (2D),","3 Star,",Athirapally ,1009,2,1
Delightful Athirapally Tour Packages,5274,4799,"Leh (3D),Nubra Valley (1D),Pangong (1D),","3 Star,",Leh ,475,5,3
Discover The Gems Of Leh Tour Package,25274,22999,"London (6D),York (1D),Edinburgh (2D),Scotland (1D),Manchester (1D),","4 Star,4 Star,5 Star,",London ,2275,11,5
Awe-Inspiring Scotland Sightseeing Tour Packages,106209,96650,"Pattaya (2D),Bangkok (2D),Phuket (3D),","2 Star,",Pattaya ,9559,7,3
Popular Thailand Family Tour Packages For A Joyous Vacation,21666,19499,"Jaipur (3D),","3 Star,",Jaipur ,2167,3,1
Jubilant Jaipur Sightseeing Tour Package,6593,6000,"Pachmarhi (3D),","3 Star,",Pachmarhi ,593,3,1
Spectacular Pachmarhi Tours,12307,11199,"Bangkok (4D),","3 Star,4 Star,",Bangkok ,1108,4,1
Adventure-Loaded Bangkok Tour Package,20604,18750,"Singapore (4D),","3 Star,",Singapore ,1854,4,1
Most Reasonable Singapore Tour Packages For A Joyous Family Vacation,39976,36500,"Rishikesh (1D),Mussoorie (2D),","3 Star,",Rishikesh ,3476,3,2
Exciting Rishikesh Tour Package,16587,15094,"Coorg (2D),Ooty (2D),Kodaikanal (3D),","3 Star,",Coorg ,1493,7,3
Book This Popular Coorg Tour Package For 7 Days For A Cozy Getaway,26142,23789,"INTERLAKEN (2D),Zurich (2D),Paris (4D),","2 Star,3 Star,4 Star,",INTERLAKEN ,2353,8,3
Summer Special Switzerland & France Tour Package,98076,89249,"Shimla (2D),Manali (3D),Dharamshala (1D),Dalhousie (2D),Amritsar (2D),","3 Star,",Shimla ,8827,10,5
Best 9 Nights 10 Days Himachal Family Tour Packages for a Thrilling Trip,38989,36500,"Amsterdam (3D),","3 Star,",Amsterdam ,2489,3,1
Wonderful Netherlands Sightseeing Tour Packages,20769,18900,"Auli (3D),","3 Star,",Auli ,1869,3,1
Top Auli Holiday Packages for an Exemplary Experience in Uttarakhand,13889,12500,"Guwahati (2D),","4 Star,4 Star,5 Star,",Guwahati ,1389,2,1
Alluring Assam Tour Package,9890,9000,"Pattaya (3D),Bangkok (3D),","3 Star,4 Star,5 Star,",Pattaya ,890,6,2
Best Bangkok Pattaya Tour Packages For An Ideal Family Vacation,15936,12749,"Kochi (1D),Munnar (2D),Thekkady (1D),Alleppey (1D),Kumarakom (1D),Kovalam (1D),Kanyakumari (1D),Trivandrum (1D),","2 Star,3 Star,4 Star,5 Star,",Kochi ,3187,9,8
Scenic Kerala Family Trip,38212,33228,"Paro (1D),Thimphu (3D),","3 Star,",Paro ,4984,4,2
Most Affordable Bhutan Family Tour Packages,18626,16950,"Rishikesh (1D),Haridwar (2D),","3 Star,",Rishikesh ,1676,3,2
Best-Selling Rishikesh And Haridwar Tour Packages,8653,7874,"Udaipur (5D),","4 Star,",Udaipur ,779,5,1
Delightful Udaipur Sightseeing Tour Package,15384,13999,"Istanbul (4D),","4 Star,",Istanbul ,1385,4,1
3 Nights 4 Days Turkey Vacation: Exploring Gems Of Istanbul,38181,33599,"Krabi (3D),Phuket (4D),","3 Star,",Krabi ,4582,7,2
Alluring Krabi Sightseeing Tour Packages,38736,35250,"Rome (2D),Florence (2D),Venice (3D),","4 Star,",Rome ,3486,7,3
Passionate Italy Sightseeing Tour Package,71552,65112,"Athens (2D),Santorini (4D),","4 Star,",Athens ,6440,6,2
Top-Selling Santorini Tour Packages From India,63461,57750,"Goa (4D),","3 Star,",Goa ,5711,4,1
Best-Selling Goa Tour Packages for an Exciting Vacation,12637,11500,"Athens (4D),Mykonos (2D),Santorini (3D),","3 Star,4 Star,",Athens ,1137,9,3
An Astounding Greece Tour Package,78461,71400,"Rome (2D),Florence (2D),Venice (3D),","4 Star,",Rome ,7061,7,3
Incredible Europe Honeymoon Package,123876,110250,"Kuta (3D),Gianyar (2D),Ubud (1D),","4 Star,4 Star,5 Star,",Kuta ,13626,6,3
Enchanted Indonesia Journeys,37362,33999,"Pattaya (4D),Bangkok (3D),","4 Star,",Pattaya ,3363,7,2
Relaxing Thailand Family Holiday Package,20250,16875,"Cappadocia (2D),Istanbul (3D),","3 Star,",Cappadocia ,3375,5,2
Enthralling Turkey Tour Package,46769,42560,"Pelling (3D),","3 Star,",Pelling ,4209,3,1
Wondrous Pelling Tour Package,23063,20757,"Hanoi (3D),Halong Bay (1D),","4 Star,4 Star,5 Star,",Hanoi ,2306,4,2
Wondrous Vietnam Tour Package,27912,25400,"Kandy (1D),Nuwara Eliya (2D),Kirinda (1D),Kalutara (1D),Dehiwala-Mount Lavinia (1D),Colombo (1D),","4 Star,4 Star,5 Star,",Kandy ,2512,7,6
Super Amazing Sri Lanka Tour Packages Of 6 Nights 7 Days ,34615,31500,"Pattaya (3D),Bangkok (4D),","3 Star,",Pattaya ,3115,7,2
Magical Thailand Family Tour Package,18213,14999,"Phnom Penh (2D),Siem Reap (3D),","3 Star,4 Star,5 Star,",Phnom Penh ,3214,5,2
Thrilling Cambodia Sightseeing Tour Package,35054,31899,"Goa (3D),","3 Star,4 Star,5 Star,",Goa ,3155,3,1
Fun-Packed Goa Weekend Holiday: South Goa & Beaches,17255,14999,"Pattaya (2D),Bangkok (3D),","3 Star,",Pattaya ,2256,5,2
Wholesome Bangkok Pattaya Tour Packages For An Exemplary Tour,11519,9599,"Coorg (3D),","3 Star,",Coorg ,1920,3,1
Most-Picked Karnataka Tour Packages For 3 Days,15417,14029,"Kuala Lumpur (3D),","3 Star,",Kuala Lumpur ,1388,3,1
Splendid Kuala Lumpur Tour Package,20879,19000,"New Delhi (3D),","3 Star,",New Delhi ,1879,3,1
Phenomenal Delhi Tour Package,4395,3999,"Ho Chi Minh City (4D),","4 Star,",Ho Chi Minh City ,396,4,1
Stupendous Vietnam Family Tour Package ,15600,13000,"Madurai (1D),Rameshwaram (1D),Kanyakumari (3D),","3 Star,",Madurai ,2600,5,3
Wholesome Rameshwaram Tour Packages For An Ideal Tour,18098,16469,"Shillong (3D),","4 Star,",Shillong ,1629,3,1
Spectacular Shillong Tour For A Refreshing Getaway With Loved Ones,12637,11500,"Amsterdam (2D),Prague (2D),Budapest (2D),","3 Star,",Amsterdam ,1137,6,3
Amazing Netherlands Package,69230,62999,"Auli (4D),","2 Star,3 Star,4 Star,5 Star,",Auli ,6231,4,1
Stunning Auli Tour Package,14285,12999,"Jaipur (2D),Mandawa (1D),Bikaner (1D),Jaisalmer (2D),Jodhpur (1D),Udaipur (2D),Pushkar (2D),","4 Star,",Jaipur ,1286,11,7
Explore The Most Awesome Destinations Of Rajasthan,42684,37999,"Macau (3D),","3 Star,",Macau ,4685,3,1
Fun-Tastic Macau Tour Package,32967,30000,"Siem Reap (4D),","3 Star,",Siem Reap ,2967,4,1
Idyllic Cambodia Tour Package,28461,25900,"Bangkok (4D),","3 Star,",Bangkok ,2561,4,1
Joyous Bangkok Tour Package,21840,19874,"Bangkok (4D),","3 Star,4 Star,5 Star,",Bangkok ,1966,4,1
Bewitching Bangkok Sightseeing Tour Package,15246,13874,"Sigiriya  (1D),Kandy (1D),NuwaraEliya (1D),Bentota (1D),Colombo (2D),","3 Star,",Sigiriya  ,1372,6,5
Best Selling Sri Lanka Family Tour Package,29112,25000," Ootacamund (3D),Kodaikanal (2D),Kodai (1D),","3 Star,", Ootacamund ,4112,6,3
Fun & Frolic Kodaikanal Ooty Tour Package,23461,21350,"Paris (3D),Brussels (2D),Amsterdam (3D),","4 Star,",Paris ,2111,8,3
"Customizable Amsterdam, Paris, And Brussels Tour Packages for a Vacation",73863,64999,"Jim Corbett (2D),","2 Star,3 Star,4 Star,5 Star,",Jim Corbett ,8864,2,1
Exciting Jim Corbett National Park Tour Package,5538,5040,"Udaipur (2D),Mount Abu (2D),","3 Star,",Udaipur ,498,4,2
Diligently Crafted Udaipur Packages For A Regal Experience,7714,6000,"Jamnagar (1D),Dwarka (1D),Veraval (1D),Somnath (1D),","3 Star,4 Star,",Jamnagar ,1714,4,4
Dwarka Tour Packages For A Memorable Experience On Your Next Trip,13333,12000,"Geneva (2D),INTERLAKEN (2D),Lucerne, Switzerland (2D),Zurich (3D),","3 Star,",Geneva ,1333,9,5
Scintillating Switzerland Family Package,112675,100281,"Ooty (3D),","3 Star,",Ooty ,12394,3,1
Top Ooty Tour Packages For A Surreal Holiday,12597,11589,"Kuala Lumpur (4D),","3 Star,4 Star,5 Star,",Kuala Lumpur ,1008,4,1
Thrilling Kuala Lumpur Sightseeing Tour Package,17582,16000,"Pattaya (1D),Bangkok (3D),","3 Star,",Pattaya ,1582,4,2
Best Selling Thailand Family Holiday Package For The Best Asian Escapade,23905,19124,"London (3D),","2 Star,",London ,4781,3,1
Resplendent London Tour Package,31500,28350,"Dharamshala (4D),","3 Star,",Dharamshala ,3150,4,1
4 Days Dharamshala Tour Packages For A Fun-filled Vacation,16667,15000,"London (2D),Edinburgh (4D),","3 Star,4 Star,5 Star,",London ,1667,6,2
Enlivening London And Edinburgh Tour Package,75833,68250,"Auckland (2D),Rotorua (2D),Christchurch (3D),Queenstown (3D),Franz Josef (1D),","3 Star,",Auckland ,7583,11,5
11 Days Grand New Zealand Self Drive Tour Package,117109,114000,"Jodhpur (1D),Jaisalmer (2D),Bikaner (1D),Jaipur (2D),","4 Star,",Jodhpur ,3109,6,4
Rajasthan 6 Days Tour Package,52838,41999,"Singapore (6D),","3 Star,4 Star,5 Star,",Singapore ,10839,6,1
Great Singapore Family Tour Package,95385,86800,"Mahe (3D),Praslin (3D),","2 Star,3 Star,4 Star,",Mahe ,8585,6,2
Charming Seychelles Tour Package,60876,57832,"Calangute (6D),","3 Star,",Calangute ,3044,6,1
Best of Goa: Exciting Family Vacation Package,39360,32800,"Istanbul (2D),Cappadocia (4D),","3 Star,",Istanbul ,6560,6,2
5 Nights 6 Days Alluring Turkey Holiday Package,49635,44240,"Dehradun (1D),Auli (3D),Mussoorie (2D),Dhanaulti (2D),","3 Star,",Dehradun ,5395,8,4
Best Selling Auli Tour Packages For A Refreshing Break,33833,30450,"Cappadocia (1D),Kusadasi (1D),Pamukkale (1D),","3 Star,4 Star,",Cappadocia ,3383,3,3
Summer Special Turkey Tour Packages,36923,33600,"Gangtok (3D),Lachen (1D),Lachung (1D),Kalimpong (1D),Darjeeling (2D),","4 Star,",Gangtok ,3323,8,5
"Adventurous Sikkim, Kalimpong & Darjeeling Tour Package ",69818,65587,"Istanbul (4D),","5 Star,",Istanbul ,4231,4,1
Magical Turkey Tour Package,55384,50399,"Athens (2D),Santorini (2D),Mykonos (2D),Istanbul (4D),Cappadocia (2D),","3 Star,",Athens ,4985,12,5
Historical And Adventurous Greece Tour,184615,168000,"Amman (1D),Tiberias (2D),Bethlehem (3D),Saint Catherine (1D),Cairo (3D),","4 Star,",Amman ,16615,10,5
Enlightening Israel Family Package with Jordan and Egypt,181222,161288,"Calodyne (7D),","4 Star,",Calodyne ,19934,7,1
Unforgettable Mauritius Tour Package,51945,47270,"Cape Town (5D),","3 Star,",Cape Town ,4675,5,1
Stunning Cape Town Tour Package,59090,51999,"Mount Abu (2D),","2 Star,3 Star,4 Star,",Mount Abu ,7091,2,1
Adventurous & Cherishable Mount Abu Tour Packages For 2 Days,5434,4999,"Jim Corbett (3D),","3 Star,4 Star,5 Star,",Jim Corbett ,435,3,1
Best Selling Jim Corbett Packages For A Refreshing Getaway ,14675,12900,"Pattaya (2D),Bangkok (2D),","3 Star,4 Star,5 Star,",Pattaya ,1775,4,2
Mini Thailand Family Package,7570,6056,"Dubai (4D),","3 Star,",Dubai ,1514,4,1
Best Selling Dubai Tour Packages For A Lavish Excursion ,30119,27500,"Shillong (3D),Cherrapunjee (1D),","2 Star,3 Star,4 Star,5 Star,",Shillong ,2619,4,2
Mesmerizing Meghalaya Tour,17032,15499,"Jaipur (3D),","3 Star,3 Star,4 Star,",Jaipur ,1533,3,1
Exemplary Jaipur Packages For A Vibrant Vacation,9333,6000,"Dwarka (3D),","3 Star,",Dwarka ,3333,3,1
Spend Some Spiritual Time at Dwarkadhish ,10786,9600,"Rishikesh (1D),Haridwar (2D),","3 Star,4 Star,5 Star,",Rishikesh ,1186,3,2
Book The Best Rishikesh Package For 2 Nights For A Filling Vacation,10439,9499,"Auckland (2D),Rotorua (2D),Lake Tekapo (1D),Queenstown (2D),Franz Josef (1D),Christchurch (2D),","4 Star,",Auckland ,940,10,6
Classic New Zealand Adventure Holiday Package,120252,111999,"Phuket (4D),","3 Star,",Phuket ,8253,4,1
Explore Our Scintillating 3 Nights 4 Days Phuket Tour Packages,31730,28874,"Auli (2D),Mussoorie (3D),","3 Star,4 Star,",Auli ,2856,5,2
A Fascinating Vacation In Auli,27707,24936,"INTERLAKEN (2D),Lucerne, Switzerland (2D),Zurich (1D),Paris (2D),Amsterdam (3D),","4 Star,",INTERLAKEN ,2771,10,6
Best Selling Europe Holiday Tour For A Refreshing Holiday,130410,120750,"Kuta (3D),Ubud (3D),","4 Star,",Kuta ,9660,6,2
"Exploring The Island Of Gods, Bali",25273,22998,"Siem Reap (2D),Phnom Penh (3D),","3 Star,4 Star,5 Star,",Siem Reap ,2275,5,2
Alluring Siem Reap - Phnom Penh Cambodia Tour Package,26404,23500,"Calangute (5D),","3 Star,4 Star,5 Star,",Calangute ,2904,5,1
Marvellous Goa Tour Packages For A Sun-Kissed Vacation,34500,25875,"Kuta (3D),Seminyak (4D),","3 Star,4 Star,",Kuta ,8625,7,2
Best Of Bali Family Trip,22180,19998,"Lisbon (2D),Madrid (2D),Seville (2D),Barcelona (3D),","3 Star,",Lisbon ,2182,9,4
Spain And Portugal Holiday Package,119599,106310,"Mount Abu (3D),","4 Star,",Mount Abu ,13289,3,1
Affordable 2 Nights 3 Days Mount Abu Family Tour Packages,8791,8000,"Amsterdam (2D),Limburgerhof (1D),Engelberg (2D),Geneva (1D),Paris (3D),","3 Star,",Amsterdam ,791,9,5
Fantastic European Delight Tour Package,101997,92817,"Udaipur (5D),","2 Star,",Udaipur ,9180,5,1
Delightful Udaipur Tour Package,14285,12999,"Mysore (2D),","4 Star,5 Star,",Mysore ,1286,2,1
Phenomenal Travel Package For Magical Mysore,8043,7319,"Candolim (7D),","3 Star,",Candolim ,724,7,1
Jumbo Goa Family Holiday Package,40588,36529,"Mussoorie (2D),Dhanaulti (1D),Jim Corbett (2D),Kausani (2D),Ranikhet (1D),Nainital (3D),","3 Star,4 Star,",Mussoorie ,4059,11,6
Delightful Uttarakhand Family Tour Package,46534,40950,"Gangtok (3D),Lachen (1D),Lachung (1D),Pelling (1D),Darjeeling (2D),","3 Star,4 Star,",Gangtok ,5584,8,5
Exotic Sikkim Tour Packages for a Mesmerising Holiday,15964,14966,"Rome (2D),Florence (2D),Venice (2D),Paris (3D),","3 Star,4 Star,",Rome ,998,9,4
Charming Italy & France Family Package ,103703,93333,"Madrid (4D),Seville (2D),Barcelona (2D),Ibiza (1D),","3 Star,4 Star,",Madrid ,10370,9,4
Most Budgeted Spain Tour Packages For A Fun Holiday ,90399,84372,"INTERLAKEN (2D),Lucerne, Switzerland (2D),Salzburg (2D),Vienna (3D),","3 Star,4 Star,5 Star,",INTERLAKEN ,6027,9,5
Perfect Austria And Switzerland Family Tour,122029,107386,"Kandy (1D),NuwaraEliya (1D),Bentota (3D),","3 Star,",Kandy ,14643,5,3
Best Selling Sri Lanka Tour Package,24333,21000,"Kasol (4D),Kheerganga (1D),Tosh (1D),","3 Star,3 Star,4 Star,",Kasol ,3333,6,3
Top Selling Budgeted Kasol Tour Packages,25000,22000,"Jamnagar (1D),Dwarka (1D),Veraval (1D),Diu (2D),","3 Star,4 Star,",Jamnagar ,3000,5,4
Best-Selling 4 Nights 5 Days Gujarat Package For A Cherishable Vacation,19764,17590,"Lucerne, Switzerland (2D),INTERLAKEN (2D),Zurich (3D),","3 Star,4 Star,5 Star,",Lucerne,2174,7,4
Best-Selling Switzerland Family Packages For A Memorable Trip,97221,87499,"Calangute (6D),","3 Star,4 Star,5 Star,",Calangute ,9722,6,1
Splendid Goa Island Tour With Dudhsagar Falls,35359,28750,"Auckland (3D),Queenstown (4D),","3 Star,4 Star,",Auckland ,6609,7,2
Essence Of New Zealand: Exciting Holiday Package,85784,81999,"Rome (2D),Venice (2D),INTERLAKEN (2D),Lucerne, Switzerland (2D),Paris (2D),London (4D),","3 Star,",Rome ,3785,14,7
Best Europe Tour Packages For A Perfect Euro Tour,174375,162750,"Mysore (2D),","3 Star,",Mysore ,11625,2,1
Mesmerizing Mysore Trip Package,11395,10369,"Kandy (2D),NuwaraEliya (1D),Colombo (2D),","5 Star,",Kandy ,1026,5,3
Ramayana Tour Package: Walk Through Sri Lankaâs Past ,26263,22874,"Kuala Lumpur (2D),Langkawi (3D),","2 Star,3 Star,4 Star,5 Star,",Kuala Lumpur ,3389,5,2
Thrilling Malaysia Tour Package,61538,56000,"Mussoorie (2D),Haridwar (1D),Jim Corbett (1D),Nainital (3D),","3 Star,",Mussoorie ,5538,7,4
Exemplary Uttarakhand Family Tour Packages For A Memorable Tour,28327,26499,"Ahmedabad (1D),Dwarka (2D),Veraval (1D),Diu (1D),Sasan Gir (2D),","3 Star,",Ahmedabad ,1828,7,5
6 Nights 7 Days Gujarat Family Tour Packages For A Refreshing Getaway,23076,20999,"Bhuj (3D),","3 Star,",Bhuj ,2077,3,1
Popular Kutch Tour Package,23736,21600,"Mussoorie (2D),Dhanaulti (2D),","4 Star,3 Star,5 Star,",Mussoorie ,2136,4,2
Perfect Mussoorie Tour Package,16666,14999,"Kuta (3D),Seminyak (3D),","2 Star,",Kuta ,1667,6,2
Bali Family Holiday Package,31862,28200,"Bhalukpong (1D),Dirang (1D),Tawang (3D),Bomdila (2D),","3 Star,4 Star,5 Star,",Bhalukpong ,3662,7,4
Best Selling 6 Nights And 7 Days Arunachal Pradesh Tour,39560,36000,"Sydney (3D),Melbourne (3D),Cairns (3D),Gold Coast (3D),","3 Star,",Sydney ,3560,12,4
Best Of Australia: Great Barrier Reef & Penguin Parade,109655,106000,"Mysore (3D),","3 Star,4 Star,5 Star,",Mysore ,3655,3,1
Best 2 Night 3 Days Mysore Tour Package For A Reviving Getaway,11522,10370,"Kochi (1D),Munnar (2D),Thekkady (1D),Alleppey (1D),Kovalam (3D),","3 Star,4 Star,5 Star,",Kochi ,1152,8,5
Charismatic Kerala Family Holiday Package,27156,25798,"Gold Coast (4D),Cairns (3D),Sydney (4D),Melbourne (4D),","3 Star,4 Star,5 Star,",Gold Coast ,1358,15,4
Exquisite Australia Tour Packages for a Spellbinding Vacation,140800,137500,"Gold Coast (3D),Sydney (4D),","3 Star,",Gold Coast ,3300,7,2
Wholesome & Fun-Filled Australia 7 Days Tour Packages,77969,72400,"Mahabaleshwar (4D),","3 Star,",Mahabaleshwar ,5569,4,1
Memorable Mahabaleshwar Family Package For 3 Nights 4 Days,13296,12099,"Jaipur (2D),Bikaner (1D),Jaisalmer (2D),Jodhpur (2D),","4 Star,5 Star,",Jaipur ,1197,7,4
Riveting Rajasthan Sightseeing Tour Package,21097,19198,"Nusa Dua (4D),Ubud (3D),","5 Star,",Nusa Dua ,1899,7,2
Mesmerizing Bali Family Vacation,35000,31500,"Maldives (4D),","3 Star,5 Star,",Maldives ,3500,4,1
Fascinating Maldives Family Tour Package,87500,77000,"Kuta (3D),Legian (3D),","3 Star,",Kuta ,10500,6,2
Blithesome Bali Family Tour Package,37640,33500,"Srinagar (2D),Gulmarg (1D),","3 Star,",Srinagar ,4140,3,2
Infinitely Romantic Jammu And Kashmir Honeymoon Package,21429,19500,"Munnar (1D),Alleppey (2D),","5 Star,",Munnar ,1929,3,2
South India Honeymoon Package For 2 Nights 3 Days,17503,16103,"Kodaikanal (3D),","2 Star,",Kodaikanal ,1400,3,1
Fanciful Kodaikanal Honeymoon Package,23461,21350,"Shillong (4D),","3,  4,  5 Star, Hotels Included",Shillong ,2111,4,1
Mesmerizing Meghalaya Tour Package,16476,14499,"Dubai (5D),","â¹ 45,999/-â¹ 49,493/-",Dubai ,1977,5,1
Dazzling Budapest Sightseeing Tour Package,69230,62999,"Budapest (2D),Vienna (2D),Prague (3D),","4 Star,",Budapest ,6231,7,3
Best Selling Deals Of Bangkok Local Packages For A Wonderful Trip,16304,15000,"Bangkok (3D),","4 Star,",Bangkok ,1304,3,1
Pleasurable Singapore Tour Package,51733,48500,"Singapore (6D),","3 Star,4 Star,5 Star,",Singapore ,3233,6,1
Breathtaking Hong Kong Family Tour,51648,47000,"Hong Kong (4D),Macau (3D),","4 Star,",Hong Kong ,4648,7,2
Splendid Singapore Tour Package,66316,60000,"Singapore (7D),","3 Star,",Singapore ,6316,7,1
A Refreshing Summer Special Spain Tour Package,80769,73500,"Lisbon (2D),Madrid (2D),Seville (2D),Barcelona (3D),","3 Star,",Lisbon ,7269,9,4
Scenic Sri Lanka Family Tour Package ,21187,18399,"Kandy (1D),NuwaraEliya (1D),Kalutara (1D),Bentota (1D),","3 Star,4 Star,5 Star,",Kandy ,2788,4,4
Magical Himachal Trip Packages From Mumbai,39011,35500,"Shimla (3D),Manali (3D),Dharamshala (1D),Dalhousie (1D),Khajjiar (1D),","4 Star,",Shimla ,3511,9,5
Breathtaking and Fun Filled Tour of Paro,20489,18645,"Paro (4D),","3 Star,",Paro ,1844,4,1
 Egypt Tour Package For 6 Nights 7 Days,62554,56924,"Cairo (5D),Luxor (2D),","4 Star,",Cairo ,5630,7,2
Supreme Singapore Tour Package With Cruise,60440,55000,"Singapore (5D),","4 Star,",Singapore ,5440,5,1
Charismatic Phuket Tour Package,32143,29250,"Phuket (4D),","5 Star,",Phuket ,2893,4,1
Dubai Family Trip Package,34065,30999,"Dubai (7D),","3 Star,",Dubai ,3066,7,1
Wonderful Summer Special Family Tour To Verdant Coorg,26142,23789,"Coorg (3D),","5 Star,",Coorg ,2353,3,1
Best Of Vietnam And Cambodia Family Tour,23998,21598,"Hanoi (3D),Ho Chi Minh City (2D),Siem Reap (3D),","4 Star,",Hanoi ,2400,8,3
Exotic Rome Sightseeing Tour Package,83278,75783,"Rome (2D),Venice (2D),Paris (3D),","3 Star,",Rome ,7495,7,3
Astounding Tour Package To Kasol,12637,11500,"Kasol (2D),Malana  (1D),","3 Star,",Kasol ,1137,3,2
Spectacular Udaipur Honeymoon Package,8241,7499,"Udaipur (3D),","3 Star,",Udaipur ,742,3,1
Fun-Filled Gangtok & Darjeeling Family Tour ,66084,57073,"Darjeeling (2D),Gangtok (4D),","3 Star,4 Star,",Darjeeling ,9011,6,2
Splendid Mount Abu Summer Festival Package,17582,16000,"Mount Abu (3D),","4 Star,",Mount Abu ,1582,3,1
Perfect Cambodia and Vietnam Family Holiday Package,74157,66000,"Ho Chi Minh City (2D),Hoi An (2D),Hanoi (3D),Siem Reap (2D),Phnom Penh (3D),","3 Star,4 Star,5 Star,",Ho Chi Minh City ,8157,12,5
Fascinating Goa Honeymoon,15934,14500,"Goa (4D),","4 Star,",Goa ,1434,4,1
Spectacular Belgium Tour Package,28846,26250,"Brussels (4D),","3 Star,",Brussels ,2596,4,1
Endearing Mauritius Family Tour Package,42840,37699,"Mauritius (7D),","3 Star,3 Star,5 Star,",Mauritius ,5141,7,1
Heavenly Darjeeling Sightseeing Tour Package,24710,22486,"Darjeeling (4D),","2 Star,",Darjeeling ,2224,4,1
Fun-Filled Hong Kong Family Tour Package,34090,29999,"Hong Kong (4D),","3 Star,4 Star,5 Star,",Hong Kong ,4091,4,1
Sensational Himachal Tour Package From Chennai,42308,38500,"Shimla (2D),Manali (3D),Dharamshala (2D),Dalhousie (2D),","4 Star,",Shimla ,3808,9,4
Jubilant France Family Package,71295,64166,"Paris (3D),Amsterdam (2D),Brussels (2D),","4 Star,4 Star,",Paris ,7129,7,3
Sensational Netherlands Tour Package,23333,21000,"Amsterdam (3D),","4 Star,",Amsterdam ,2333,3,1
A Royal Udaipur Family Tour Package,7608,6999,"Udaipur (3D),","3 Star,3 Star,4 Star,5 Star,",Udaipur ,609,3,1
Astonishing Himachal Tour Package From Bangalore,36484,33200,"Shimla (2D),Manali (3D),Dharamshala (1D),Dalhousie (3D),","3 Star,",Shimla ,3284,9,4
Holy Char Dham Package: Badrinath,9230,8399,"Haridwar (2D),Badrinath (2D),","2 Star,",Haridwar ,831,4,2
A Short And Sweet Puri Tour Package,10483,9540,"Puri (3D),","3 Star,",Puri ,943,3,1
Scintillating Shillong Sightseeing Tour Package,9890,9000,"Shillong (3D),","3 Star,",Shillong ,890,3,1
Sublime Gangtok Package For Family ,31821,28002,"Gangtok (4D),","2 Star,3 Star,4 Star,",Gangtok ,3819,4,1
Religious Char Dham Tour Packages,10384,9449,"Haridwar (3D),Barkot (2D),Uttarkashi (2D),","2 Star,",Haridwar ,935,7,3
Spellbinding Santorini Sightseeing Tour Package,46153,41999,"Santorini (4D),","4 Star,",Santorini ,4154,4,1
"USA Tour Package: Las Vegas, LA, San Francisco",175824,160000,"Las Vegas (2D),Los Angeles (2D),San Francisco (3D),","3 Star,",Las Vegas ,15824,7,3
Kerala Houseboat Trip Package For 4 Nights 5 Days,23946,20400,"Munnar (2D),Thekkady (1D),Alleppey (2D),","3 Star,",Munnar ,3546,5,3
Lovely Goa Family Tour,12921,11500,"Calangute (4D),","3 Star,",Calangute ,1421,4,1
Magnificent Kasol Tour Package,13187,12000,"Kasol (1D),Kheerganga (3D),","2 Star,",Kasol ,1187,4,2
Amazing Switzerland and Paris Tour Package,111138,105289,"INTERLAKEN (2D),Lucerne, Switzerland (2D),Zurich (2D),Paris (3D),","3 Star,4 Star,",INTERLAKEN ,5849,9,5
Enchanting Turkey Tour,104396,95000,"Cappadocia (3D),Antalya (2D),Istanbul (3D),Turkey (1D),","5 Star,",Cappadocia ,9396,9,4
Thrilling Dharamshala Tour Package,16484,15000,"Dharamshala (4D),","3 Star,",Dharamshala ,1484,4,1
Bewitching Mauritius Family Tour Package,29805,26825,"Mauritius (7D),","3 Star,3 Star,5 Star,",Mauritius ,2980,7,1
An Invigorating Madurai Sightseeing Tour Package,21796,19834,"Madurai (3D),Rameshwaram (1D),Kanyakumari (1D),Kovalam (1D),","3 Star,",Madurai ,1962,6,4
Delightful Kodaikanal Sightseeing Tour Package,16758,15250,"Kodaikanal (3D),","2 Star,",Kodaikanal ,1508,3,1
Exotic Goa Tour,21098,19199,"Goa (5D),","5 Star,",Goa ,1899,5,1
3 Country Europe Tour Package,137999,125999,"Rome (2D),Venice (2D),INTERLAKEN (2D),Lucerne, Switzerland (2D),Paris (3D),","3 Star,4 Star,",Rome ,12000,11,6
Scenic Thailand Family Package,23864,21000,"Phuket (5D),","3 Star,4 Star,5 Star,",Phuket ,2864,5,1
Turkey Tour Package,81495,74704,"Istanbul (4D),Cappadocia (2D),Kusadasi (2D),Pamukkale (1D),","3 Star,4 Star,",Istanbul ,6791,9,4
A Blissful Goa Honeymoon Package,15164,13799,"Goa (5D),","3 Star,",Goa ,1365,5,1
Joyous Summer Special Prague Tour Package,23076,20999,"Prague (3D),","4 Star,",Prague ,2077,3,1
Amazing Goa Family Tour: Forts & Adventure,19756,16500,"Goa (4D),","2 Star,3 Star,5 Star,",Goa ,3256,4,1
Best-Selling Holidays To The Maldives With Family,135326,124500,"Maldives (5D),","5 Star,",Maldives ,10826,5,1
Greece And Turkey Summer Special Tour Package,172480,156800,"Athens (2D),Santorini (2D),Mykonos (2D),Istanbul (4D),Cappadocia (2D),","3 Star,4 Star,",Athens ,15680,12,5
Spell-Binding Mussoorie Tour Package,16770,15093,"Mussoorie (3D),","3 Star,",Mussoorie ,1677,3,1
Fascinating Pattaya Tour Package,29257,26624,"Pattaya (4D),","4 Star,",Pattaya ,2633,4,1
Enchanting Netherlands Holiday Package,23076,20999,"Amsterdam (3D),","4 Star,",Amsterdam ,2077,3,1
Amazing Barcelona Sightseeing Tour Package,57692,52500,"Barcelona (7D),","4 Star,",Barcelona ,5192,7,1
Supreme Mauritius Family Package,42222,38000,"Mauritius (6D),","3 Star,5 Star,",Mauritius ,4222,6,1
Mesmerizing Sikkim & Darjeeling Family Tour Package ,55399,50782,"Gangtok (2D),Pelling (1D),Darjeeling (3D),","3 Star,4 Star,",Gangtok ,4617,6,3
Amusing Austria Tour Package,40384,36749,"Vienna (2D),Innsbruck (2D),Austria (1D),","3 Star,",Vienna ,3635,5,3
Super Saver: Sri Lanka Family Holiday Package,29294,25299,"Kandy (1D),NuwaraEliya (1D),Bentota (3D),","3 Star,4 Star,5 Star,",Kandy ,3995,5,3
Offbeat Uttarakhand Tour,17308,15750,"Nainital (2D),Mukteshwar (2D),","3 Star,",Nainital ,1558,4,2
Heavenly Hong Kong Family Tour Package,43956,40000,"Macau (2D),Hong Kong (6D),","3 Star,",Macau ,3956,8,2
Alluring Himachal Tour Package From Ahmedabad,36484,33200,"Shimla (3D),Manali (3D),Dharamshala (1D),Dalhousie (1D),Khajjiar (1D),","4 Star,",Shimla ,3284,9,5
Gorgeous Gir Tour Package,11648,10600,"Sasan Gir (2D),Gir (1D),","3 Star,",Sasan Gir ,1048,3,2
Cheerful Cambodia Vietnam Family Holiday ,26610,23949,"Hanoi (2D),Halong Bay (1D),Ho Chi Minh City (2D),Siem Reap (4D),","5 Star,",Hanoi ,2661,9,4
Amazing Agra Tour Package,8791,8000,"Agra (1D),New Delhi (3D),","3 Star,",Agra ,791,4,2
"Refreshing Gangtok, Kalimpong & Darjeeling Tour Package",62409,56982,"Gangtok (3D),Kalimpong (1D),Darjeeling (3D),","3 Star,4 Star,",Gangtok ,5427,7,3
Engaging Leh Tour,46153,41999,"Leh (5D),Hunder (1D),","3 Star,",Leh ,4154,6,2
Delightful Dubai Tour With Vegetarian Food,28000,25000,"Dubai (5D),","3 Star,4 Star,5 Star,",Dubai ,3000,5,1
Rejuvenating Rameshwaram Tour,16758,15250,"Madurai (1D),Rameshwaram (1D),Kanyakumari (3D),","2 Star,",Madurai ,1508,5,3
A Mesmerizing Tawang Tour Package,32417,29499,"Bhalukpong (1D),Dirang (1D),Tawang (4D),Tezpur (1D),","3 Star,",Bhalukpong ,2918,7,4
An Amazing Kasol And Kheerganga Tour Package,17033,15500,"Kasol (2D),Kheerganga (1D),Tosh (2D),","3 Star,",Kasol ,1533,5,3
Rejuvenating Summer Special Shimla Tour Package,16484,15000,"Shimla (4D),","3 Star,",Shimla ,1484,4,1
Astonishing Turkey Family Package,25846,23520,"Cappadocia (2D),Kusadasi (1D),","3 Star,",Cappadocia ,2326,3,2
Lovable Gangtok Family Package,25044,22289,"Gangtok (3D),","2 Star,3 Star,4 Star,",Gangtok ,2755,3,1
A Blissful Getaway to Bali,37362,33999,"Kuta (6D),Ubud (3D),Nusa Dua (2D),","5 Star,",Kuta ,3363,11,3
Enjoyable Tamil Nadu Tour Package,12736,11590,"Ooty (3D),","2 Star,",Ooty ,1146,3,1
A Fantabulous Cherrapunji Trip Package,12637,11500,"Cherrapunjee (3D),","3 Star,",Cherrapunjee ,1137,3,1
Captivating Delhi Tour Package,8791,8000,"Agra (1D),New Delhi (3D),","3 Star,",Agra ,791,4,2
Dubai Family Package For 4 Nights 5 Days,47872,45000,"Dubai (5D),","5 Star,",Dubai ,2872,5,1
Fascinating Goa Tour Package,17582,16000,"Goa (5D),","3 Star,",Goa ,1582,5,1
Weekend In Kerala-Vythiri With Tree House Stay,21215,20154,"Wayanad (4D),","3 Star,4 Star,5 Star,",Wayanad ,1061,4,1
Fun-tastic Hong Kong Holiday & Lantau Island Tour,49728,45998,"Hong Kong (6D),","4 Star,",Hong Kong ,3730,6,1
Amazing Alleppey Houseboat Tour Package,17913,16122,"Alleppey (2D),","3 Star,4 Star,5 Star,",Alleppey ,1791,2,1
Marvels of Hong Kong and Macau Family Tour,38043,35000,"Hong Kong (3D),Macau (3D),","4 Star,",Hong Kong ,3043,6,2
Alluring Alleppey Tour Package,10774,9804,"Alleppey (3D),","3 Star,",Alleppey ,970,3,1
Mystical Santorini Tour,46153,41999,"Santorini (4D),","4 Star,",Santorini ,4154,4,1
Mauritius Holiday Package For Families	,42994,37620,"Mauritius (6D),","4 Star,",Mauritius ,5374,6,1
Adventurous Sariska Tour Package,5354,4500,"sariska (3D),","3 Star,3 Star,",sariska ,854,3,1
Adventurous Ranthambore Tour Package,7734,6500,"Ranthambore (3D),","3 Star,3 Star,",Ranthambore ,1234,3,1
Adventurous Dharamshala Sightseeing Tour Packages,13736,12500,"Dharamshala (4D),","3 Star,",Dharamshala ,1236,4,1
Intimate Sri Lanka Honeymoon Package,26153,23799,"Kandy (1D),Bentota (1D),Colombo (2D),","4 Star,",Kandy ,2354,4,3
Magical Meghalaya Tour Package,14366,12498,"Shillong (3D),","3 Star,",Shillong ,1868,3,1
Stunning Austria Tour Package,40384,36749,"Vienna (2D),Salzburg (2D),Austria (1D),","3 Star,",Vienna ,3635,5,3
Exhilarating Goa Tour,15384,13999,"Goa (4D),","4 Star,",Goa ,1385,4,1
"Thrilling Gangtok, Pelling, Darjeeling Family Trip",54981,50583,"Gangtok (2D),Pelling (1D),Darjeeling (2D),","2 Star,3 Star,4 Star,",Gangtok ,4398,5,3
Stunning Leh Tour,32966,29999,"Leh (5D),Nubra Valley (2D),Pangong (1D),","3 Star,",Leh ,2967,8,3
Amazing Sri Lanka Holiday: Whale Watching & Turtle Hatchery ,23657,19800,"NuwaraEliya (1D),Bentota (2D),Colombo (1D),","3 Star,4 Star,5 Star,",NuwaraEliya ,3857,4,3
Exotic USA Tour Package,274725,250000,"New York (2D),Washington DC (1D),Niagara Falls (2D),Chicago (1D),Orlando (5D),Bahamas  (3D),","3 Star,",New York ,24725,14,6
Pristine Paro Sightseeing Tour Package,16763,15254,"Paro (4D),","2 Star,",Paro ,1509,4,1
Splendid Spain Honeymoon Tour Package,69230,62999,"Barcelona (7D),","4 Star,",Barcelona ,6231,7,1
A Pleasant Tour In Munnar,11243,10231,"Munnar (3D),","3 Star,",Munnar ,1012,3,1
A Tour Amid Nature In Kodaikanal,29677,27006,"Coorg (2D),Ooty (2D),Kodaikanal (3D),","3 Star,",Coorg ,2671,7,3
20 Days To Fall In Love: The Ultimate New Zealand Tour Package ,226538,217000,"Auckland (2D),Paihia (3D),Rotorua (2D),Wellington (1D),Christchurch (4D),Queenstown (5D),Dunedin (1D),Franz Josef (2D),","3 Star,4 Star,5 Star,",Auckland ,9538,20,8
Surreal Dalhousie Tour Packages,24685,22463,"Dalhousie (3D),","3 Star,",Dalhousie ,2222,3,1
Alluring Agra Sightseeing Tour Package,5494,5000,"Agra (3D),","3 Star,",Agra ,494,3,1
Remarkable Kasauli Tour Package,16434,15119,"Kasauli (2D),","3 Star,",Kasauli ,1315,2,1
Delightful Nainital Mukteshwar Family Package,14423,13125,"Nainital (2D),Mukteshwar (2D),","3 Star,",Nainital ,1298,4,2
Lovely Delhi Tour Package,10989,10000,"Agra (1D),New Delhi (3D),","3 Star,",Agra ,989,4,2
Unique USA Sightseeing Tour Package,185714,169000,"Orlando (8D),New York (2D),","3 Star,",Orlando ,16714,10,2
Invigorating Himachal Tour Package,36044,32800,"Shimla (2D),Manali (2D),Mcleodganj (1D),Dalhousie (3D),","3 Star,",Shimla ,3244,8,4
Ecstatic Cambodia Tour Package,35054,31899,"Siem Reap (2D),Phnom Penh (4D),","4 Star,",Siem Reap ,3155,6,2
Boisterous Bangkok Thailand Family Tour Package,33516,30500,"Pattaya (2D),Bangkok (3D),","3 Star,",Pattaya ,3016,5,2
Have A Fantastic Tawang Trip Full Of Joy,35714,32500,"Bhalukpong (1D),Dirang (1D),Tawang (2D),Bomdila (2D),","3 Star,",Bhalukpong ,3214,6,4
Extraordinary New Zealand Tour Package,103296,93999,"Auckland (1D),Rotorua (2D),Queenstown (2D),Franz Josef (2D),Christchurch (2D),","4 Star,",Auckland ,9297,9,5
Delightful Macau Sightseeing Tour Package ,43956,40000,"Macau (3D),","4 Star,",Macau ,3956,3,1
Spiritual Char Dham Yatra Package,20769,18900,"Haridwar (3D),Barkot (2D),Uttarkashi (2D),Sitapur (3D),Badrinath (1D),","2 Star,",Haridwar ,1869,11,5
Nepal Family Tour,30989,28200,"kathmandu (4D),POKHARA (2D),Sauraha (2D),","3 Star,",kathmandu ,2789,8,3
Spellbinding Athens Sightseeing Tour Package,63461,57750,"Athens (2D),Santorini (4D),","4 Star,",Athens ,5711,6,2
Exhilarating Auli Tour Package,14583,13125,"Auli (3D),","2 Star,",Auli ,1458,3,1
Blissful Shimla Tour Package,13930,12816,"Shimla (4D),","2 Star,",Shimla ,1114,4,1
Mysore: A Culturally Rich City,14076,12809,"Mysore (3D),","3 Star,",Mysore ,1267,3,1
Astounding Mauritius Package,118681,108000,"Mauritius (6D),Dubai (4D),","5 Star,",Mauritius ,10681,10,2
A Revitalizing Tamil Nadu Tour Package,16758,15250,"Ooty (4D),","3 Star,",Ooty ,1508,4,1
Spellbinding Cambodia Famliy Tour Package,73404,66798,"Siem Reap (2D),Phnom Penh (4D),","3 Star,",Siem Reap ,6606,6,2
Awesome Turkey Honeymoon package,109538,99680,"Istanbul (7D),Cappadocia (2D),Kusadasi (2D),","5 Star,",Istanbul ,9858,11,3
Ravishing Rishikesh Tour Package,7500,6825,"Rishikesh (2D),","3 Star,",Rishikesh ,675,2,1
Blissful Bhutan Tour Package,72021,65539,"Paro (2D),Punakha (2D),Thimphu (3D),","4 Star,",Paro ,6482,7,3
Splendid Singapore Package,65934,60000,"Singapore (3D),Kuala Lumpur (3D),","3 Star,",Singapore ,5934,6,2
A Vacation In Magnificent Greece,98076,89249,"Athens (4D),Naxos (1D),Santorini (3D),Mykonos (2D),","3 Star,",Athens ,8827,10,4
Alluring Jaisalmer Tour Package,19662,17499,"Jaisalmer (2D),Bikaner (2D),","3 Star,",Jaisalmer ,2163,4,2
Enchanting Leh Ladakh Family Tour Package (Ex Srinagar),48102,44999,"Srinagar (1D),Kargil (1D),Leh (4D),Pangong (1D),Nubra Valley (1D),","4 Star,",Srinagar ,3103,8,5
Guwahati Trip Package,12636,11499,"Guwahati (3D),","3 Star,",Guwahati ,1137,3,1
Unforgettable Bali Family Tour Package,37840,33299,"Nusa Dua (2D),Seminyak (3D),","4 Star,5 Star,",Nusa Dua ,4541,5,2
Enriching Kochi Munnar Family Tour Package,14332,12899,"Cochin (1D),Munnar (3D),","3 Star,4 Star,5 Star,",Cochin ,1433,4,2
Divine Dharamshala Honeymoon Package,14945,13600,"Dharamshala (2D),Dalhousie (3D),","3 Star,",Dharamshala ,1345,5,2
Kerala Weekend Special: Kumarakom Backwaters & Munnar Hills,12214,12092,"Munnar (2D),Kumarakom (2D),","3 Star,4 Star,5 Star,",Munnar ,122,4,2
 Thrilling Dubai Desert Safari Tour Package,37500,34500,"Dubai (6D),","3 Star,4 Star,5 Star,",Dubai ,3000,6,1
Thrilling Hong Kong Sightseeing Packages,40659,37000,"Hong Kong (5D),","4 Star,",Hong Kong ,3659,5,1
An Enthralling Jodhpur Sightseeing Tour Package,10989,10000,"Jodhpur (1D),Jaisalmer (3D),","2 Star,",Jodhpur ,989,4,2
Natural New Zealand Sightseeing Tour Package,90109,81999,"Christchurch (2D),Franz Josef (2D),Queenstown (3D),","3 Star,",Christchurch ,8110,7,3
Exhilarating Malaysia Tour Package,63736,58000,"Kuala Lumpur (2D),Langkawi (3D),","4 Star,",Kuala Lumpur ,5736,5,2
Amazing Kuala Lumpur Tour Package,19780,18000,"Kuala Lumpur (4D),","3 Star,",Kuala Lumpur ,1780,4,1
Abu Dhabi Tour Package,35164,31999,"Abu Dhabi (3D),","3 Star,",Abu Dhabi ,3165,3,1
Breathtaking Ladakh Family Package ,69999,62999,"Srinagar (1D),Kargil (1D),Leh (2D),Nubra Valley (2D),Pangong (1D),sarchu (1D),Manali (2D),","2 Star,3 Star,4 Star,",Srinagar ,7000,10,7
"Incredible Italy, Switzerland & Paris Family Package",139186,123876,"Rome (2D),Venice (2D),INTERLAKEN (2D),Lucerne, Switzerland (2D),Paris (3D),","3 Star,",Rome ,15310,11,6
A Family Getaway To The Hills Of Himachal,25996,23656,"Shimla (1D),Sarahan (1D),Chitkul (1D),Narkanda (2D),","3 Star,",Shimla ,2340,5,4
Delightful Mount Abu Family Package,5494,5000,"Mount Abu (2D),","3 Star,",Mount Abu ,494,2,1
Kerala is a Land of Wonders,22988,20000,"Kochi (1D),Munnar (2D),Thekkady (1D),Kovalam (3D),","3 Star,4 Star,5 Star,",Kochi ,2988,7,4
Bewitching Pelling Tour Package,15995,14875,"Pelling (2D),","3 Star,",Pelling ,1120,2,1
Delightful Cambodia Tour Package,28913,25299,"Phnom Penh (2D),Siem Reap (4D),","3 Star,",Phnom Penh ,3614,6,2
Exciting Kanyakumari-Kovalam Family Tour Package ,13068,11500,"Kovalam (2D),Kanyakumari (2D),","3 Star,4 Star,5 Star,",Kovalam ,1568,4,2
Elegant Srinagar Tour Package,20225,18000,"Srinagar (2D),","4 Star,",Srinagar ,2225,2,1
Sizzling Pattaya Sightseeing Tour Package,37362,33999,"Pattaya (4D),","4 Star,",Pattaya ,3363,4,1
Adventurous Assam Tour Package,15730,14000,"Kaziranga National Park (3D),","3 Star,",Kaziranga National Park ,1730,3,1
"New Zealand Queenstown, Rotorua & Franz Josef Family Holiday Package",150081,142000,"Auckland (2D),Paihia (2D),Rotorua (1D),Queenstown (4D),Franz Josef (2D),Christchurch (2D),","3 Star,4 Star,5 Star,",Auckland ,8081,13,6
Ecstatic Cambodia Vietnam Family Holiday Package,61111,55000,"Hanoi (3D),Ho Chi Minh City (3D),Siem Reap (2D),Phnom Penh (3D),","3 Star,4 Star,5 Star,",Hanoi ,6111,11,4
Gleeful Rann Of Kutch Tour Package,22087,20099,"Bhuj (2D),Kutch (3D),","3 Star,",Bhuj ,1988,5,2
